11 15
###############
#H  #     #   #
# # # ### # # #
# #   # # # # #
# ##### # # # #
#       #   # #
####### ### # #
#   #       # #
# # # ##### # #
# #         #C#
###############
